ATM	articulación temporomandibular
ATM	articulación témporo mandibular
AHI	apnea-hypopnea index
MAAs	mandibular advancement appliance
ESCQ	Emotional Skills and Competence Questionnaire
ESCQ	Emotional Skills and Competence Questionnaire
RIETE	Registro Informatizado de Enfermedad Tromboembólica
ETEVI	enfermedad tromboembólica venosa idiopática
HTP	hipertensión pulmonar
AP	Atención Primaria
TRT	tiempo en rango terapéutico
INR	razón normalizada internacional
S.	Serratia
EA	embolización arterial
RP	radical prostatectomy
PSA	prostate-specific antigen
RT	radiation therapy
CTCs	circulating tumour cells
PCa	prostate cancer
AP	atención primaria
SIT	specific immunotherapy
DMO	densidad mineral ósea
DE	desviaciones estándar
OR	odds ratio
LIV	leiomiomatosis intravenosa
EA	enfermedad de Alzheimer
TPET	Trastornos por Estrés Postraumático
OA	artrosis
STFF	síndrome de transfusión fetal-fetal
CIR	crecimiento fetal selectivo
TRAP	perfusión arterial reversa
CHA	common hepatic artery
SMA	superior mesenteric artery
RHA	right hepatic artery
CBD	common bile duct
LHA	left hepatic arteries
ELA	embolismo de líquido amniótico
GPC	guías de práctica clínica
DME	detección de malestar emocional
DME	Detección de Malestar Emocional
ICO	Institut Català d?Oncologia
UCP	Unidad de Cuidados Paliativos
HPB	hiperplasia benigna de próstata
AP	atención primaria
IPSS	International Prostate Symptom Score
PSA	prostate-specific antigen
SEMERGEN	Sociedad Española de Médicos de Atención Primaria
SEMG	Sociedad Española de Medicina General
semFYC	Sociedad Española de Medicina de Familia y Comunitaria
AEU	Asociación Española de Urología
CCT	Columbia Card Task
DHD	dosis diarias definidas por 1.000 habitantes y día
ISRS	inhibidor selectivo de la recaptación serotoninérgica
TDAH	trastorno por déficit de atención e hiperactividad
RCV	riesgo cardiovascular
PAAF	punción aspiración con aguja fina
CT	condiciones tácticas
VPH	virus del papiloma humano
SPI	síndrome de las piernas inquietas
LES	lupus eritematoso sistémico
Ta	temperatura central
PAS	presión arterial sistólica
IRVS	índice de resistencias vasculares sistémicas
SAM	senescence-accelerated mouse
CIR	crecimiento intrauterino restringido
CMR	células de Müller de la retina
BDNF	factor neurotrófico derivado del cerebro
CGR	células ganglionares de la retina
AL	adrenalectomía laparoscópica
ITU	infecciones del tracto urinario
SECO	Sociedad Española de Cirugía de la Obesidad
PC	perímetro de cintura
HDL	lipoproteínas de alta densidad
PCRus	proteína C reactiva ultrasensible
CV	riesgocardiovascular
CTx	carboxy-terminal telopeptide of collagen type 1
CTx	fracción ? del colágeno tipo 1
CATK	catepsina K
B-ALP	bone alkaline phosphatase
B-ALP	fosfatasa alcalina ósea
P1NP	amino-terminal propeptide of procollagen type 1
P1NP	propéptido aminoterminal del procolágeno 1
IPED	Inventario Psicológico de Ejecución Deportiva
IPED	Inventario Psicológico de Ejecución Deportiva
DM	diabetes mellitus
CL	columna lumbar
CF	cuello femoral
IMC	índice de masa corporal
DMO	densidad mineral ósea
FAVI	Fístulas arteriovenosas
HD	Hemodiálisis
AP	atención primaria
BZD	benzodiazepinas
CVCs	catéteres venosos centrales
DM	diabetes
CRC	colorectal cancer
DFS	disease-free survival
OST	overall survival time
NAFLD	Nonalcoholic fatty liver disease
FTO	obesity-associated gene
DN	dolor neuropático
TRE	tratamiento de reemplazoenzimático
CF	crisis Fabry
AP	acroparestesias
EC	enfermedad celíaca
IAMCEST	infarto agudo de miocardio con elevación del ST
UCI	unidades de cuidados intensivos
HUB	Hospital Universitario de Bellvitge
DSE	disección submucosa endoscópica
USE	ultrasonografía endoscópica
LDL	lipoproteínas de baja densidad
PRP	plasma rico en plaquetas
SPB	sarcomas de partes blandas
GEIS	Grupo Español de Investigación de Sarcomas
CC	cognitivoconductual
ANP	atrial natriuretic peptide
BNP	brain natriuretic peptide
CNP	C-type natriuretic peptide
Uro	urodilatin
FDA	Federal Drug Administration
AHF	acute heart failure
JG	grupo de entrenamiento en piscina con uso de multisaltos
CG	grupo control
GH	hormona de crecimiento
PRM	problemas relacionados con los medicamentos
HD	hemodiálisis
SS	sarcoma sinovial
ANOVA	análisis de la varianza
MUE	Medicina de Urgencias y Emergencias
MI	Medicina Interna
MIV	Medicina Intensiva
AyR	Anestesiología y Reanimación
MFyC	Medicina Familiar y Comunitaria
DIRAE	Seasonal allergic rhinitis distribution in Spain
SAR	seasonal allergic rhinitis
GPs	primary care physicians
ALs	allergists
VAS	visual analogical scale
NHP	Nottingham Health Profile
PHC	primary healthcare
HABS-U	Healthcare-worker's Aggresive Behaviour Scale-Users
DAS	Escala de Ira al Conducir
DAS	Driving Anger Scale
BSGC	biopsia selectiva del ganglio centinela
GC	ganglio centinela
ELA	esclerosis lateral amiotrófica
CCR	cáncer colorrectal
NBI	narrow band imaging
LEP	Listado de Enfermedades Profesionales
SAF	síndrome de la Arcada de Frohse
TSE	tratamiento de sustitución enzimática
DN	diabetes neonatal
DNT	diabetes neonatal transitoria
DNP	diabetes neonatal        permanente
KATP	canales pancreáticos de potasio sensibles al ATP
AEP	Spanish Association of Paediatrics
HGUA	Hospital General Universitario de Alicante
EPOC	enfermedad pulmonar obstructiva crónica
NAC	neumonía adquirida en la comunidad
D.T	tiempo medio de abstinencia hasta el diagnóstico de síndrome de abstinencia alcohólica
ACSM	American College Sports Medicine
UPDRS	Unified Parkinson's Disease Rating Scale
EP	enfermedad de Parkinson
IMC	índice de masa corporal
EW	enfermedad de Whipple
WBI	irradiar la mama entera
UBCT	ultra-brief-challenge test
TDAH	trastorno de déficit de atención/hiperactividad
PrEFiNE	Plan estratégico para la enfermedad de Fabry en Nefrología
EF	enfermedad de Fabry
PA	physical activity
PA	presión arterial
HbA1c	glucohemoglobina
cLDL	colesterol unido a lipoproteínas de baja densidad
DMD	desprendimiento de la membrana de Descemet
SGC	Sistemas de gestión de Calidad
HD	hemodiálisis
SPB	sarcomas de partes blandas
UTME	Unidad de Tumores Músculo-Esqueléticos
ENS	Encuesta Nacional de Salud
HCE	historia clínica electrónica
IC	intervalos de confianza
SEM	sistemas de emergencias médicas
CCU	Centros de Coordinación de Urgencias
CCAA	comunidades autónomas
DMS	sulfuro de dimetilo
FBG	glucemia en ayuno
AOS	antidiabéticos orales solos
EPOC	enfermedad pulmonar obstructiva crónica
WAZ	weight-for-age
BMIZ	BMI-for-age
ABP	aprendizaje basado en problemas
STALYC	Sociedad de Trasplantes de América Latina y el Caribe
BSGC	biopsia selectiva del ganglio centinela
IA	insuficiencia suprarrenal
SEEN	Sociedad Española de Endocrinología y Nutrición
ICA	índice creatinina-altura
PFR	proteína fijadora de retinol
OPS	Organización Panamericana de la Salud
OMS	Organización Mundial de la Salud
MP	mortalidad perinatal
RN	recién nacidos
TSK	temperaturas máximas y medias de la piel
RDI	regiones corporales de interés
UCM	Universidad Complutense de Madrid
FAISEM	Fundación Andaluza para la Integración Social del Enfermo Mental
PFAPA	periodic fever, aphtas, pharyngitis and cervical adenopathies
ILAE	International Ligue Against Epilepsy
ES	esclerosis sistémica
EAP	equipos de atención primaria
PASSIR	Programas de Atención a la Salud Sexual y Reproductiva
OFC	oficinas de farmacia comunitaria
OR	odds ratios
IC	intervalos de confianza
EF	ejercicio físico
VMNI	ventilación mecánica no invasiva
UBA	unidades básicas de atención
ITRD	Texas Revised Inventory of Grief Manual
Hg	mercury
As	arsenic
Se	selenium
Hg	Mercury
As	arsenic
Se	selenium
GST	glutathione S-transferase
IHT	involuntary hospital treatment
WHYMPI	Inventario Multidimencional de Dolor West-Haven-Yale
ERC	espasmo del reflejo de cerca
CLA	conjugated linoleic acid
AF	animal fat
PSORD	psoriasis-reumato-dermato
SGB	síndrome de Guillain-Barré
UCI	unidades de cuidados intensivos
pTBred	Red Española de Estudio de la Tuberculosis Infantil
SUP	servicio de urgencias pediátrico
TCE	traumatismo craneoencefálico
PSF	Programa de Salud Familia
MMP	metaloproteasas
EIM	espesor íntima-media
PCR	hs-proteína C reactiva
DREZ	zona de entrada de la raíz dorsal
MOS-SSS	Medical Outcomes Study-Social Support Survey
UCI	unidades de cuidados intensivos
CLSI	Clinical and Laboratory Standards Institute
EIIC	enfermedad inflamatoria intestinal crónica
AI	aspergilosis invasoras
PCT	procalcitonina
MR-proANP	pro-péptido natriurético auricular
MR-proADM	pro-adrenomedulina
SCAP	severe CAP
NAC	neumonía adquirida en la comunidad
CB	candidosis bucal
MB	mucosa bucal
DM	diabéticos
DM	diabéticos
PE	Prueva exacta
OR	odds ratio
LC	límite de confianza
NF1	neurofibromatosis tipo 1
RM	resonancia magnética
RME	RM espectroscópica
V-P	ventriculoperitoneal
TADH	Trastorno por déficit de atención e hiperactividad
DE	desviación estándar
OLZ	olanzapina
EP	enfermedad de Parkinson
PIF	psicosis inducida por fármacos
PANSS	Positive and Negative Symptoms Scale
UPDRS	Unified Parkinson's Disease Rating Scale
RCP	reanimación cardiopulmonar
DEA	Desfibrilación Automática Externa
PCR	parada cardiorrespiratoria
RA	Reanimación Avanzada
CMV	citomegalovirus
RN	recién nacido
PDMAR	Plan Director de Enfermedades del Aparato Respiratorio
VHC	virus de la hepatitis C
VIH	virus de la inmunodeficiencia humana
LM	lactancia materna
OMS	Organización Mundial de la Salud
IC	intervalo de confianza
PIN	Neoplasia Intraepitelial Prostática
AGF	Atípia Glandular Focal
TDAH	trastorno por déficit de atención/hiperactividad
PTC	pseudotumor        cerebral
IMC	índice masa corporal
LCR	líquido cefalorraquídeo
LPP	linfoma pulmonar primario
BALT	linfoma asociado al tejido linfoidebronquial
OMS	Organización Mundial de la Salud
EFP	especialidades farmacéuticas publicitarias
GP	granulomatosis con poliangeítis
ANCA	anticuerpos anticitoplasma de neutrófilo
PNET	tumor primitivo neuroectodérmico
ETEV	enfermedad tromboembólica venosa
VRS	virus respiratorio sincitial
t-AP	activador del plasminógeno tipo tisular
EGFR	receptor del factor de crecimiento epidérmico
GH	grado histológico
FS	fase de síntesis
IVE	interrupción voluntaria del embarazo
ECI	Espacio Científico Iberoamericano
OA	oral anticoagulation
INR	International Normalized Ratio
AINE	analgésicos antitérmicos y antiinflamatorios no esteroideos
EVA	escala visual analógica
TGE	tumores germinales extragonadales
DI	discapacidad intelectual
BPEG	bajo peso para la edad gestacional
IMC	índice de masa corporal
PSI	Programa de servicios individualizados
TMS	trastornos mentales severos
prot.	proteína
Rb	retinoblastoma
EVA	escala visual analógica
SS	síndrome de Sjögren
OLS	Overall Life Satisfaction
PE	Proceso de Atención de Enfermería
FDDT´s	Fast Dissolving Disintegrating Tablets
G3	genotype 3
HVL	high viral load
RVR	rapid virological response
SVR	sustained virological response
RBV	ribavirin
Dargen-3	high versus standard dose of ribavirin plus peginterferon alfa-2a in hepatitis C genotype 3 and high viral load
PXE	seudoxantoma elástico
EA	estrías angioides
NVC	neovascularización coroidea
R	recirculación
IM	infarto de miocardio
(DTC-c	Doppler transcraneal con contraste
CDI	comunicación derecha-izquierda
MV	maniobra de Valsalva
VPP	valor predictivo positivo
VPN	valor predictivo negativo
RM	resonancia magnética
NSOCs	Non syndromic orofacial clefts
BMP7	Bone morphogenetic protein 7
TGF-beta	transforming growth factor-beta
LD	linkage disequilibrium
TDT	transmission disequilibrium test
rHuEp	eritropoyetina recombinante
IRC	insuficiencia renal crónica
VIH	virus de la inmunodeficiencia humana
CBCT	cone beam computed tomography
ANC	Atención nutricional convencional
ANC	atendimiento nutricional convencional
CE	consumo energético
NE	necesidad        energética
k	Coeficiente Kappa
DAS	Dysfunctional Attitude Scale
DAS-R	revised, 17-item version of the DAS
CFA	confirmatory factor analysis
SED	Sociedad Española de Diabetes
FRCV	factores de riesgo cardiovascular
DM	diabetes mellitus
DPP	depresión posparto
EPDS	Edinburgh Postnatal Depressión Scale
IC	intervalo de confianza
TDL	tubo de doble luz
BBA	bloqueador bronquial de Arndt
SD	síndrome de Down
ERON	especies reactivas de oxígeno y nitrógeno
ERGE	enfermedad por reflujo gastro-esofágico
TDAH	trastorno por déficit de atención e hiperactividad
DSM	Diagnostic and Statistical Manual of Mental Disorders
CIE	Clasificación Internacional de las Enfermedades
AB	ABI PRISM 310
FQ	fibrosis quística
ACV	accidente cerebrovascular
ACVI	ACV isquémico
CFNR	capa de fibras nerviosas de la retina
NAAS	neumonía asociada a la asistencia sanitaria
SAHS	síndrome de apneas-hipopneas del sueño
CLL	Chronic lymphocytic leukaemia
CGH	comparative genomic hybridisation
FISH	fluorescence in situ hybridisation
MLPA	multiplex ligation- dependent probe amplification
SUZ	síndrome de Urrets-Zavalía
DSAEK	Descemet Stripping Automated Endothelial Keratoplasty
VINCat	vigilancia de la infección nosocomial en los hospitales de Cataluña
SARM	Staphylococcus aureus resistente a meticilina
PCLN1	paracelina-1
HAN	home artificial nutrition
OWAS	Ovako Working Posture Analysing System
OCRA	Occupational Repetitive Action
MPFC	medial prefrontal cortex
upp	úlceras por presión
NLA	nevus lentiginoso atípico
TSN	tratamiento sustitutivo con parches de nicotina
ITB	índice tobillo-brazo
EAP	enfermedad arterial periférica
RCV)	riesgo cardiovascular Framingham
FRCV	factores de riesgo cardiovasculares
AP	atención primaria
EPOC	enfermedad pulmonar obstructiva crónica
GH	hormona de crecimiento
AUC	área bajo la curva
NP	número de pulsos
AP	área de los pulsos
G	grandes
P	pequeños
NP	nutrición parenteral
DBS-PS	Disruptive Behavior Scale Professed by Students
DBS-PS	Disruptive Behavior Scale Professed by Students
RTU	resección transuretral
TM	tumor vesical
SCE	Supervivencia cáncer-específica
PLE	periodo libre de enfermedad
NPD	Nutrición Parenteral Domiciliaria
THC	tetrahidrocannabinol
EM	esclerosis múltiple
TLP	personalidad el trastorno límite
IPDE	International Personality Disorders Examination
UCEM	Unidad de Corta Estancia Médica
EPOC	enfermedad pulmonar obstructiva crónica
ICC	insuficiencia cardíaca congestiva
C.Isq	cardiopatía isquémica
ECVA	enfermedad cerebrovascular aguda
PCR	Reacción en Cadena de la Polimerasa
APA	American Psychological Association
CPR	cuidados paliativos renales
TSR	tratamiento sustitutivo renal
TRS	tratamiento sustitutivo renal
CP	cuidados paliativos
ITB	baclofén intratecal
CDV	calidad de vida
ECG	electrocardiograma
IHQ	inmunohistoquímica
FISH	hibridación fluorescente in situ
dPCR	PCR diferencial
DMAE	degeneración macular asociada a la edad
ADHD	Attention deficit hyperactivity disorder
TDAH	trastorno por déficit de atención/hiperactividad
BGC	biopsia selectiva del ganglio centinela
GC	ganglio centinela
DM	Diabetes Mellitus
PAM	presión arterial media
EP	enfermedad de Parkinson
EDM	episodios depresivos mayores
UPDRS	evaluación con escala unificadapara la EP sección motora
NPI	inventario neuropsiquiátrico
IDB	inventario para la depresiónde Beck
LEG	lupus eritematoso generalizado
ECV	eventos cardiovasculares
SAF	síndrome antifosfolípido
IAMC	índices adiposo-musculares corporales
CCI	coeficiente de correlación intraclase
CBC	carcinoma basocelular
VH	vejiga hiperactiva
SEGG	Sociedad Española de Geriatría y Gerontología
SEMERGEN	Sociedad Española de Médicos de Atención Primaria
CI	cociente intelectual
DLFT	demencia lobar frontotemporal
LIWS	ondas de choque de baja intensidad
DE	disfunción eréctil
DE	disfunción eréctil
IIEF-6	??ndice Internacional de la Función Eréctil-6
SEP	Perfil de Encuentro Sexual
GAQ	eficacia global del tratamiento
MCQ	memory characteristics questionnaire
MCQ	Memory Characteristics Questionnaire
MD	melanoma desmoplásico
MIQ-R	cuestionario-revisado de imagen del movimiento
MIQ-R	Cuestionario-Revisado de Imagen del Movimiento
VMIQ	Cuestionario de Viveza de Imagen del Movimiento
VVIQ	Cuestionario de Viveza de Imagen Visual
VCM	volumen corpuscular medio
AST	aspartato aminotransferasa
ALT	alanino aminotransferasa
GGT	gammaglutamiltransferasa
L-Arg	L-arginina
NO	óxido nítrico
WRR	ratio de recuperación del trabajo
TW3S	trabajo total
NOx	nitrato plasmático
PT	Prueba de Tuberculina
PBR	Países de Baja Renta
SQTC	síndrome de QT corto
RM	resonancia magnética
GEA	gastroenteritis aguda
BIS	biespectral
EMPB	enfermedad de mano-pie-boca
SPT	skin prick tests
NT	nasal IgE test
NPT	Nasal provocation test
CF	Castigo Físico
ASA	aspirin
NP	nasal polyposis
Tm	transferencias
TEP	Test de Equilibrio Peritoneal
GAMA	grupo alto/medio-alto
GBMB	grupo bajo/mediobajo
TAO	tratamiento anticoagulante por vía oral
SICATA	Sistema de Información de la Coordinación Autonómica de Trasplante de Andalucía
HOMA	evaluada a través del modelo homeostático
BMW	aguas minerales bicarbonatadas ricas en sodio
LMW	agua mineral débil
QUICKY	índice de sensibilidad cuantitativa a la insulina
RP	proctocolectomy
IN	infección nosocomial
UCIP	Unidades de Cuidados Intensivos Pediátricas
CVC	catéter venoso central
VM	ventilación mecánica
SV	sondaje vesical
EPOC	enfermedad pulmonar obstructiva
CAT	test de evaluación de la EPOC
FP	falsos positivos
FN	falsos negativos
S	sensibilidad
E	especificidad
A1C	hemoglobina A1C
LDL-C	lipoproteinas de bajadensidad
EM	esclerosismúltiple
RM	resonancia magnética
VEGF	factor de crecimiento del endotelio vascular
FGF	factor de crecimiento de fibroblastos
BCVA	best corrected visual acuity
ICUs	intensive care units
ICC	inmunocomplejos circulantes
ANA	anticuerposantinucleares
ANCA	anticuerpos anticitoplasma deneutrófilos
ACA	anticuerpos anticardiolipina
VIH	virus de la inmunodeficiencia humana
IC	intervalo de confianza
OR	odds ratio
NCC	neurocisticercosis
BNT	Boston Naming Test
DE	desviación estándar
IN	infección nosocomial
SNED	sistema neuroendocrino difuso
AVPD	avoidant personality disorder
VIH+	virus humano de inmunodeficiencia adquirida positivo
VIH+	virus humano de imunodeficiencia adquirida positivo
NUVE	Núcleo de Vigilancia Epidemiológica
AZT	Zidovudine
AZT	zidovudina
CCR	cáncer colorrectal
S	sensibilidad
VPP	valor predictivo positivo
LR+	cociente de probabilidad positivo
NND	númerode colonoscopias para diagnosticar
CCAP	Consulta de Conexión con Atención Primaria
STUI	síntomas del tracto urinario inferior
SDT	síndrome de déficit de testosterona
CP	cáncer de próstata
PR	prostatectomía radical
BMW	aguas minerales bicarbonatadas ricas en sodio
PA-TMG	Programa de Atención a Personas con Trastorno        Mental Grave
